[TILESHEET]
ARQUIVO = spritesheet.png
LARGURA_TILE = 128
ALTURA_TILE = 64
TILES_POR_LINHA = 7
TILE_LAVA = 3
TILE_PISADO = 6
TILE_AGUA = 5

[MAPA]
DIMENSOES = 15 15
CAMINHAVEL = 0 1 2 4 5 6
DADOS =
2 2 2 2 2 2 2 2 2 2 2 2 2 2 2
2 5 5 5 5 5 5 5 5 5 5 1 1 1 2
2 5 5 5 5 5 5 5 5 1 1 1 1 1 2
2 5 5 5 5 5 5 5 5 1 1 1 1 1 2
2 5 5 5 1 1 1 1 1 1 1 1 1 1 2
2 5 1 1 1 1 1 1 1 1 1 5 1 1 2
2 1 1 1 1 1 1 1 1 1 1 5 1 1 2
2 1 1 1 1 1 1 1 1 1 1 1 1 1 2
2 1 1 3 1 1 1 1 1 1 1 1 1 1 2
2 1 3 3 3 3 3 1 1 1 1 1 1 1 2
2 1 3 3 3 3 3 1 1 1 1 1 1 1 2
2 1 1 3 3 1 1 1 1 1 1 1 1 1 2
2 1 1 1 1 1 1 1 1 1 1 1 1 1 2
2 1 1 1 1 1 1 1 1 1 1 1 1 1 2
2 2 2 2 2 2 2 2 2 2 2 2 2 2 2

[OBJETOS]
P 7 7
C 4 6
C 4 8
C 10 6
C 10 8
C 7 12

[ALTURAS]
0 0 0 0 0 0 0 0 0 0 0 0 0 0 0
0 0 0 0 0 0 0 0 0 0 0 0 0 0 0
0 0 0 0 0 0 0 0 0 0 0 0 0 0 0
0 0 0 1 1 1 1 1 1 1 1 1 0 0 0
0 0 0 1 1 1 1 1 1 1 1 1 0 0 0
0 0 0 1 1 0 0 0 0 0 1 1 0 0 0
0 0 0 1 1 0 0 0 0 0 1 1 0 0 0
0 0 0 1 1 0 0 2 0 0 1 1 0 0 0
0 0 0 1 1 0 0 0 0 0 1 1 0 0 0
0 0 0 1 1 0 0 0 0 0 1 1 0 0 0
0 0 0 1 1 1 1 1 1 1 1 1 0 0 0
0 0 0 1 1 1 1 1 1 1 1 1 0 0 0
0 0 0 0 0 0 0 0 0 0 0 0 0 0 0
0 0 0 0 0 0 0 0 0 0 0 0 0 0 0
0 0 0 0 0 0 0 0 0 0 0 0 0 0 0